1 1 1 1 1 1 1 1 1 1 0 0 0 0 0 0 0 0 0 0
1 1 1 1 1 1 1 1 1 1 0 0 0 0 0 0 0 0 0 0
1 1 1 8 8 8 8 1 1 1 0 0 0 8 8 8 8 0 0 0
1 1 1 8 8 8 8 1 1 1 0 0 0 8 8 8 8 0 0 0
4 7 1 8 8 8 8 1 1 1 0 0 0 8 8 8 8 0 0 2
1 1 1 8 8 8 8 1 1 1 0 0 0 8 8 8 8 0 0 0
1 4 1 8 8 8 8 1 1 1 0 0 0 8 8 8 8 0 2 0
1 1 1 8 8 8 8 1 1 1 0 0 0 8 8 8 8 0 0 0
1 1 1 1 1 8 8 1 1 1 0 0 0 8 8 0 0 0 0 0
1 1 1 1 1 1 1 1 1 1 0 0 0 0 0 0 0 0 0 0
0 0 0 0 0 0 0 0 0 0 1 1 1 1 1 1 1 1 1 1
0 0 0 0 0 8 8 0 0 0 1 1 1 8 8 1 1 1 1 1
0 0 0 8 8 8 8 0 0 0 1 1 1 8 8 8 8 1 1 1
0 2 0 8 8 8 8 0 0 0 1 1 1 8 8 8 8 1 4 1
0 0 0 8 8 8 8 0 0 0 1 1 1 8 8 8 8 1 1 1
2 6 0 8 8 8 8 0 0 0 1 1 1 8 8 8 8 1 1 4
0 0 0 8 8 8 8 0 0 0 1 1 1 8 8 8 8 1 1 1
0 0 0 8 8 8 8 0 0 0 1 1 1 8 8 8 8 1 1 1
0 0 0 0 0 0 0 0 0 0 1 1 1 1 1 1 1 1 1 1
0 0 0 0 0 0 0 0 0 0 1 1 1 1 1 1 1 1 1 1
