0 6 0 0 0 0 0 0 0 0 1 1 1 1 1 1 1 4 1 1
0 0 0 0 0 0 0 0 0 0 1 1 1 1 1 1 1 1 1 1
0 0 0 0 0 0 0 0 0 0 1 1 1 1 1 1 1 1 1 1
0 0 0 0 0 0 0 8 8 8 8 8 8 1 1 1 1 1 1 1
0 0 0 0 2 0 0 8 8 8 8 8 8 8 8 8 8 8 8 4
0 2 0 0 0 0 0 8 8 8 8 8 8 8 8 8 8 8 8 1
0 0 0 0 0 0 0 8 8 8 8 8 8 8 8 8 8 8 8 1
0 0 0 0 0 0 0 8 8 8 8 8 8 8 8 8 8 8 8 1
0 0 0 0 0 0 0 8 8 8 8 8 8 8 8 8 8 8 8 1
0 0 0 0 0 0 0 0 0 0 1 1 1 8 8 8 8 8 8 1
1 1 1 1 1 1 1 1 1 1 0 0 0 8 8 8 8 8 8 0
1 1 1 1 1 1 1 8 8 8 8 8 8 8 8 8 8 8 8 0
1 1 1 1 1 1 1 8 8 8 8 8 8 8 8 8 8 8 8 0
1 1 1 1 1 1 1 8 8 8 8 8 8 8 8 8 8 8 8 0
1 4 1 1 1 1 1 8 8 8 8 8 8 8 8 8 8 8 8 0
1 1 1 1 4 1 1 8 8 8 8 8 8 8 8 8 8 8 8 2
1 1 1 1 1 1 1 8 8 8 8 8 8 0 0 0 0 0 0 0
1 1 1 1 1 1 1 1 1 1 0 0 0 0 0 0 0 0 0 0
1 1 1 1 1 1 1 1 1 1 0 0 0 0 0 0 0 0 0 0
1 7 1 1 1 1 1 1 1 1 0 0 0 0 0 0 0 2 0 0
